10 10 10 10 10 10 10 10 10 10 10 10 10 10 10 10 10 10 10 10 10 10 10 10 10 10 10 10 10 10 10 10 10 10 10 10 10 10 10 10 10 10 10 10 10 10 10 10 10 10
10 10 10 10 10 10 10 10 10 10 10 10 10 10 10 10 10 10 10 10 10 10 10 10 10 10 10 10 10 10 10 10 10 10 10 10 10 10 10 10 10 10 10 10 10 10 10 10 10 10
10 10 10 10 10 10 10 10 10 10 10 10 10 10 10 10 10 10 10 10 10 10 10 10 10 10 10 10 10 10 10 10 10 10 10 10 10 10 10 10 10 10 10 10 10 10 10 10 10 10
10 10 10 10 10 10 10 10 10 10 10 10 5 5 5 5 5 5 5 5 5 5 10 10 10 10 10 10 10 10 10 10 10 10 10 10 10 10 10 10 10 10 10 10 10 10 10 10 10 10
10 10 10 10 10 10 10 10 10 10 10 10 5 5 5 5 5 5 5 5 5 5 10 10 10 10 10 10 10 10 10 10 10 10 10 10 10 10 10 10 10 10 10 10 10 10 10 10 10 10
10 10 10 10 10 10 10 10 10 10 10 10 5 5 5 5 5 5 5 5 5 5 10 10 10 10 10 10 10 10 10 10 10 10 10 10 10 10 10 10 10 10 10 10 10 10 10 10 10 10
10 10 10 10 10 10 10 10 10 10 10 10 5 5 5 5 5 5 5 5 5 5 10 10 10 10 10 10 10 10 10 10 10 10 10 10 10 10 10 10 10 10 10 10 10 10 10 10 10 10
10 10 10 4 4 4 4 5 5 5 10 10 5 5 5 5 7 7 7 7 7 7 5 5 5 5 5 5 5 10 10 10 10 10 10 10 10 10 10 10 10 10 10 10 10 10 10 10 10 10
10 10 10 4 5 4 4 4 4 5 10 10 5 5 5 5 7 7 7 7 7 7 5 5 5 5 5 5 5 10 10 10 10 10 10 10 10 10 10 10 10 10 10 10 10 10 10 10 10 10
10 10 10 4 4 4 5 4 4 5 10 10 5 5 5 5 7 7 7 7 7 7 5 5 5 5 5 5 5 5 10 10 10 10 10 10 10 10 10 10 10 10 10 10 10 10 10 10 10 10
10 10 10 4 4 5 4 4 4 5 10 10 5 5 5 5 5 5 5 5 5 5 5 5 5 5 5 5 5 5 10 10 10 10 10 10 10 7 10 10 10 10 10 10 10 10 10 10 10 10
10 10 10 5 4 4 4 4 4 5 5 5 5 5 5 5 5 5 5 5 5 5 5 5 5 5 5 5 5 10 10 10 10 10 10 10 7 11 7 5 5 5 5 5 5 5 5 5 10 10
10 10 5 5 4 4 5 4 4 4 5 5 5 5 5 5 5 5 5 5 5 5 5 5 5 5 5 5 5 10 10 10 10 10 10 10 7 5 7 5 5 5 5 5 5 5 5 5 10 10
10 10 5 4 4 4 5 4 5 4 5 5 5 5 5 5 5 5 5 5 5 5 5 5 5 5 5 5 5 8 8 8 8 8 10 10 5 5 5 5 5 5 5 5 5 5 5 5 10 10
10 10 5 5 4 4 4 5 4 4 5 5 5 5 5 5 5 5 5 5 5 5 5 5 5 5 5 5 5 8 8 8 8 8 8 8 5 5 5 5 5 5 5 5 5 5 5 5 10 10
10 10 10 5 5 4 4 4 5 5 5 5 5 5 5 5 5 5 5 5 5 5 5 5 5 5 5 5 5 8 8 8 8 8 8 8 5 5 5 5 5 0 0 5 5 5 5 5 10 10
10 10 10 5 5 5 5 5 5 5 5 5 5 5 5 5 5 5 5 5 5 5 5 5 5 5 5 5 5 8 8 8 8 8 8 8 5 5 5 5 5 0 0 5 5 5 5 5 10 10
10 10 10 5 5 5 5 5 5 5 5 5 5 5 5 5 5 5 5 5 5 5 5 5 5 5 5 5 5 8 8 8 10 10 10 10 5 5 5 5 5 5 5 5 5 5 5 5 10 10
10 10 10 7 7 7 7 7 7 6 6 6 6 7 7 7 5 5 5 5 5 5 5 5 5 5 5 5 5 5 10 10 10 10 10 10 5 5 5 5 5 5 5 5 5 5 5 5 10 10
10 10 10 7 7 7 7 7 7 6 6 6 6 7 7 7 5 5 5 5 5 5 5 5 5 5 5 5 5 5 10 10 10 10 10 10 5 5 5 5 5 5 5 5 5 5 5 5 10 10
10 10 10 7 7 7 7 7 5 5 5 5 5 5 5 5 5 5 5 5 5 5 5 5 5 5 5 5 5 5 10 10 10 10 10 10 5 5 5 5 5 5 5 5 5 5 5 5 10 10
10 10 10 10 10 10 10 10 5 5 5 5 5 5 5 5 5 5 5 5 5 5 5 5 5 5 5 5 5 10 10 10 10 10 10 10 10 10 10 10 10 10 10 10 10 10 10 10 10 10
10 10 10 10 10 10 10 10 5 5 5 5 5 5 5 5 5 5 3 3 3 3 3 3 3 5 5 5 5 10 10 10 10 10 10 10 10 10 10 10 10 10 10 10 10 10 10 10 10 10
10 10 10 10 10 10 10 10 5 5 5 5 5 5 5 5 5 5 3 3 3 3 3 3 3 5 5 5 5 10 10 10 10 10 10 10 10 10 10 10 10 10 10 10 10 10 10 10 10 10
10 10 10 10 10 10 10 10 5 5 5 5 5 5 5 5 5 5 3 3 5 5 5 3 3 5 5 5 8 8 8 8 8 10 10 10 10 5 5 5 5 5 5 5 5 5 5 5 5 10
10 10 10 10 10 10 10 10 5 5 5 5 5 5 5 5 5 5 8 8 5 4 5 3 3 5 5 5 8 8 8 8 8 8 8 10 10 5 5 5 5 5 5 5 5 5 5 5 5 10
10 10 10 10 10 10 10 10 5 5 5 5 5 5 5 5 5 5 3 3 5 5 5 3 3 5 5 5 8 8 8 8 8 8 8 8 8 5 5 5 5 5 5 5 5 5 5 5 5 10
10 10 10 10 10 10 10 10 5 5 5 5 5 5 5 5 5 5 3 3 3 3 3 3 3 5 5 5 5 10 10 10 8 8 8 8 8 8 8 5 5 5 5 5 5 5 5 5 5 10
10 10 10 10 10 10 10 10 10 10 10 10 5 5 5 5 5 5 3 3 3 3 3 3 3 5 5 5 5 5 10 10 10 8 8 8 8 8 8 5 5 5 5 5 5 5 5 5 5 10
10 10 10 10 10 10 10 10 10 10 10 10 5 5 5 5 5 5 5 5 5 5 5 5 5 5 5 5 5 5 10 10 10 10 10 10 10 5 5 5 5 5 5 5 5 4 4 5 5 10
10 10 10 10 10 10 10 10 10 10 10 10 5 5 5 5 5 5 5 5 5 5 5 5 5 5 5 5 5 5 10 10 10 10 10 10 10 5 5 5 4 4 5 4 4 5 4 5 5 10
10 10 10 10 10 10 10 10 10 10 10 10 10 10 10 5 5 5 5 5 5 5 5 5 5 5 5 5 5 5 10 10 10 10 10 10 5 5 5 4 4 4 4 4 4 4 4 5 5 10
10 10 10 10 10 10 10 10 10 10 10 10 10 10 10 10 10 10 10 10 10 10 10 10 10 10 10 10 10 10 10 10 10 10 10 5 5 5 4 5 4 4 4 4 5 4 4 5 5 10
10 10 10 10 10 5 5 5 5 10 10 10 10 10 10 10 10 10 10 10 10 10 10 10 10 10 10 10 10 10 10 10 10 5 5 5 4 4 4 4 4 4 5 4 4 4 4 5 5 10
10 10 10 10 5 5 5 5 5 5 5 5 10 10 10 10 10 10 10 10 10 10 10 10 10 10 10 10 10 5 5 5 5 5 5 4 4 5 4 4 4 5 5 4 5 4 5 5 5 10
10 10 10 5 5 5 5 5 5 5 5 5 5 5 5 10 10 10 10 10 10 10 10 10 10 10 10 10 5 5 5 5 5 5 5 4 4 4 4 4 4 5 4 4 4 4 5 5 5 10
10 10 10 5 5 3 3 3 3 3 3 3 5 5 5 5 5 10 10 10 10 10 10 10 10 10 10 10 5 5 5 5 5 5 5 4 4 5 4 4 4 4 4 4 4 5 5 5 10 10
10 10 10 5 5 3 3 3 3 3 3 3 5 5 5 5 5 5 5 10 10 10 10 10 10 10 10 10 5 5 5 5 5 5 5 5 4 4 5 4 5 5 5 4 5 5 5 5 10 10
10 10 10 5 5 3 3 3 3 3 3 3 5 5 5 5 5 5 5 5 5 5 10 10 10 10 10 10 10 5 5 5 5 5 5 5 5 4 4 4 4 4 5 5 5 5 5 10 10 10
10 10 10 5 5 3 3 3 3 3 3 3 5 5 5 5 5 5 5 5 5 5 5 10 10 10 10 10 10 10 8 8 8 5 5 5 5 5 5 5 5 5 5 5 5 5 10 10 10 10
10 10 10 5 4 4 4 3 3 3 3 3 4 4 4 5 5 5 5 5 5 5 5 10 10 10 10 10 8 8 8 8 8 5 5 5 5 5 5 5 5 5 5 5 5 10 10 10 10 10
10 10 10 10 4 4 4 4 4 3 4 4 4 4 4 5 5 5 5 5 5 5 5 10 10 10 8 8 8 8 8 8 8 5 5 5 5 5 5 5 5 5 10 10 10 10 10 10 10 10
10 10 10 10 5 4 4 4 4 4 4 4 4 4 4 5 6 6 5 5 5 5 8 8 8 8 8 8 8 8 8 8 10 10 10 5 5 5 5 5 10 10 10 10 10 10 10 10 10 10
10 10 10 10 5 5 5 5 4 4 4 4 4 4 4 2 6 6 5 5 5 5 8 8 8 8 8 8 8 8 8 10 10 10 10 10 10 10 10 10 10 10 10 10 10 10 10 10 10 10
10 10 10 10 10 5 5 5 5 4 4 4 4 4 4 2 6 6 5 5 5 5 8 8 8 8 8 8 8 10 10 10 10 10 10 10 10 10 10 10 10 10 10 10 10 10 10 10 10 10
10 10 10 10 10 10 5 5 5 5 5 5 5 5 2 2 6 6 5 5 5 5 10 10 10 10 10 10 10 10 10 10 10 10 10 10 10 10 10 10 10 10 10 10 10 10 10 10 10 10
10 10 10 10 10 10 10 10 5 5 5 5 5 5 2 2 2 5 5 5 5 10 10 10 10 10 10 10 10 10 10 10 10 10 10 10 10 10 10 10 10 10 10 10 10 10 10 10 10 10
10 10 10 10 10 10 10 10 5 5 5 5 5 5 5 5 5 5 5 10 10 10 10 10 10 10 10 10 10 10 10 10 10 10 10 10 10 10 10 10 10 10 10 10 10 10 10 10 10 10
10 10 10 10 10 10 10 10 10 10 5 5 5 5 5 10 10 10 10 10 10 10 10 10 10 10 10 10 10 10 10 10 10 10 10 10 10 10 10 10 10 10 10 10 10 10 10 10 10 10
10 10 10 10 10 10 10 10 10 10 10 10 10 10 10 10 10 10 10 10 10 10 10 10 10 10 10 10 10 10 10 10 10 10 10 10 10 10 10 10 10 10 10 10 10 10 10 10 10 10
